00000000000110000100000000000000010000000000010001000010010000010000000000010010000000010000010110000
00111011110011111101011111000101111111101111001001111110010111011101011101101110011101101100011010111
00000000010000001000000100000000000001000000000000000000000100000000001001000000000000000000000000000
11001111110011001111110101111100111101010101101111101001111100111100111011001110111101101011001100111
00000001000000000000100000000000000000000001000100000000010000000000010000000000000000000000001000000
01101111011110001010010101001111001011111010111011011110101111100110111110101110001110111101111101110
01000000000000001000000000000000000000000000000000000000000000000100100000000100000000000100010000100
01111101101111001110111101111100110001101111010101010110111101011111101010110111110110110010110111011
00010000000000000100000000000000000000001000000101000000000001010000000010100000000000000000000100000
10110100111001011011111101011110111010001111101011111110111010110101111001010111111011111001111001101
00010100000000000000000101010000000000000001000000001000001010010000000000000000000010000001000000000
11111110001011010011011111111010010111110111010111101111110001110011111011101111110001111011011110011
00000000000001000000000001000000000001000000010000100001000000000000000000100000000000000010010000000
10111101101010111110001110111110011011110101110111101100110001011011111110111101011101111110111011011
10010001000000000000000000010000000000000100010001001000000000000000000000100000001000001000010000000
01101111101111011101110011100110111011101011101111001101010111111001111111000011011001110110111011101
01000010000010000000000000000010001000101000000000000000000010000001000000000000000000000000010000000
01101110110111110000011111001111101101100111011011010111101101111110100100101101100011001101111111110
01000000100000000000000000000010000000000000000010000000000000100000000000000000000000000000000000000
11011011110110101110111011101101011111101101110011101011110011111110011110110101011110111101100111111
00000000100000000000010000000001000010000000000000000010000000010000000000000001000000100000100000000
00011111110110101101011110101110011111010101101011010100111110100110101111111001111100111010001111011
00000000000000001000000100000000000000000000000010000000000000000000000001000000000000000000000001000
01001111110110001111001011010101111111110011111010111110111111111110101101000000111111010001011111101
00000000000100000000000000000000000001000000000010000000100000000000000000000000000000000000000100000
10111010011011101011110110010001111101100100110011100111011111111011110011111101100110001011110100101
00000000000000001010000000000000000000100000000000000000000000001010000000000000000000000000000000100
01110111010100110111011101111010110000111011101110010111111111001100101110111110011011011111111110000
00000000000000000000000000000000000000000010000010000000000000000000000000100000010000000100000000000
01101110011111001110011011101010011111101110110110101111010100111111101011111001110110001111011111011
00000010000000000000000000001010000000101000000000101000000100000000101000000000000000000001000010000
11111010100101101111010101001110011011110100111010111110110100111101101100110111100111111010110101110
00000000000100000000000000000000000000000000001010000000000000000001000100000000000000100000010101000
10110000111111111111110010101111010110101011101110111110001101111010111010110110111011011010011111011
10000000000000010000000000100100010100100000000000000000001001000010001010010100000010001010000001000
00110111111111000001111111110011101101110111110111011101101110110111011011111001111010110111011011100
00000000000000000000000100000001000000010001000000001001000000010010000000000001000010100100000000000
01101110011111111101101100111111011110101111010111011101110110111011111111111000011100101110111010110
01000100000000100000001000000001000010000000000001001000000000010001000000000000000000100000000000000
10101100111100111110111011111110010111111101011110111011001001110111101111110111011011101110011011110
00000000000100000000001000000000010000100001000010000000000000000000000010000010001000000000000000000
01110111110111011110101001111110111011011101011011011111101011110000111111110010110011101100101100101
00000000100001001000000000000100010010000000001000000100000000000000000000000000000000000000000000100
00100101101011101111110110111110010011101011011110011111110101010110110111111101111110010111101101011
00000000000000000000000000010000000000000000000000000100000100000000000000010001000000000100000001000
01111110101110011010011111011010111101111010111010111101101111100100111101101101111001111011100011011
00000000000000000000001000001000000100010000001010010000000100000000000000001001000000000000000000001
01111010111110100110101110111011111110111101011011111011111011100000110111111010110111101111011101111
00001000000000000000000000001000001000000001010000000000000000000000010000100000000001000010000100000
11111110010011101101111001110100111010111011110110110011101101111100111111110100001011011100100111111
10000000000010000100100000000000000000000000100000000000000000100000000000000000001001000000000000001
01101011111011011111111101101001011001111011100111111110101101110111001001110111111011101011011011110
01000000001000000001000000000001000000000001000000001000000000000010000000000000010000001010000000000
01101010100011111011111111001111011101111011101101111101010101110111001110110110101111100111010111100
00100000000000000000000100000010010000000010000001000000000100000010000000000000000010000000000000000
01111110011010011111011110111111011101111110110111110111110111111111000101011011001111111001011101101
00100000001010000000000100010000010000010000010000010000010100000000000001000000000000000000010000000
11011101011111011101111100100111011011001101111000111111011111000011110111011011101110110111010111101
00001001010000010000100000000000000001000000000000000010000000000000010000000000000100000000000100000
01000101111011011001100101001111111000101111011111100101011110110010111011111011101011011011100111110
01000000000000000000000000000000000000000000000000000000000010010000000000010000001010000000000001000
10100111110111100101101101011011111111111010111000111110101001000011111101111110010111101110000100111
00000000000000000001000100000000000000000000000000000000000000000001000001000000000000000000000000000
01101110111110100100101111001101111101101101110110111011101101111110101110111011111010110110111101011
00000000001000000000000000000000000000000001000000010001000000001000000010000000100000010000000000000
11011111001100111111011110111111000011111011101000101111111101101101101111100110000011010101101111111
00000100000000000010000010000000000000000001001000000000000001000100100000000000000000000000000000001
01101011110111011101110011011110101110101110111110011010111011000011111100111101110101110111101101011
00101000100010000000000000010000100010100100100000000000000000000000000000010000010100000000001001000
10111001001110011111010101101101101010110111011011010111011010110111110100111110001110110111110100101
00100000000000000000000000000000000000000000000000010000000000000010000000001000000000000000000000000
00011110010011110110111011101110110100111111111110011111001111010101111110110111110011111111010110001
00000000000000000000000000000000000100000001000000010000000100010000000010010000010000000000000000000
10110101011111110111111010101111001001111110111101101101111110101111010110111101000101110011011101011
00010000000000100000100000000000000000000000100000001000001000100000010000000000000000000000000000000
01111101011011001111010101110111101000001111011111011111011011000100010011111111000110000111111100111
00000000000000001000000000000000000000000000000100000000000000000000000000000000000010000000000000000
01110101110111101110111100011101111101111011011011001101110101111101101111100111111100111100101011011
00000000000100001000000000000100000100000000010000000000010100000000100100000000100000000000000000000
00011100111110000101111001111111110110011111111000111101111011101100010111111110001010111111101010010
00000000000000000000000000000000100010000000010000000000000000000000000001000000000000000000000000010
00111111011001111011101100111110111011111011110000110110111110100110101010111111010100101110101101011
00000001000000000000001000000000000010000000000000010100010000000000000000000000000000000000000000000
10110110001111110111011101111110010111110111010101110101111101111011101100011011110110011100111011011
10100000000000000100001000010000000001000100010000000000001000010010001000000000000000000000000000001
10001101111110111010111111010010111101110101110100011110110111110011101010011111001111011101001110111
00000000000100100000000000000000100000000000000000001000010010000000100000000000000000001001000000000
10111111001111101010101011001111011111011001110101111111011101110111101011011110010111101101110111101
10010000001000000010101001000000000000000000100100001000000001000010000000000100000000000000010001001
11000111110111111010101101111101111101011100111111110101011100011111101100111011110111011011110111010
00000000000001000000000000010001000001010000001000000000010000000000000000010001000010010001000001010
11101111100011111010101110101100001101111011110101111001011110101111101110111100111111100101100001111
00001000000000000000001000000000000000000000000000100000000000000010000000000000100000000000000000000
10111100111111101110110111010111011110111011010111101010111010111101110111011111101011110110101001111
00000100000000100000010000000001000000000010010010001010000000001000100000000100001010000000001000000
10111100111111101101001110011010011111100110111110100111011111111010110101011010111101111010110111011
00000000010000000000000000001010000000100000000010000000000001000000000000000000001000000010000000000
10101011111011011001011101110111001010111010111110110110001110010110111101110100111001111110100001111
00101000000000000000010000000000000010001010000000000000000000000000000000000000100000000000000000000
01110010100100101111100111111110101101111100101110110111011110101110010111000111100110110010111111101
00000000000000000000000000000000001000000000000010100000000000000000000000000100000000000000000010000
