00000000000001000000010000000001000000000000000100100000000000000100000100100000000000000100000000000
10111101110101011111101110010010011111110110111110010101111110101110101001111110101011101110110011010
00000000000000010000000000000000000100000100001000000000000100000000000000001000000000000000000010010
01111111001011111011011011101101011101111011010110111011010111011011011101111011011110110111110010110
00000000001000000001000000000000000001000000000000010000000000000010010000010000000010100100000000000
00110111111101010110011010111100011110001010111110111110111100011101110011111101000110011111101101101
00000000000000000000000010000000000010000000000000000100010000000000010000001000000000000000000000000
01110110111100111110101101111010001111111111100101101100111010111110011110111010111101111000110001111
01000000001000000000001000100000000000010000000000000000001000000100000000000000100000000000000000001
00001111011111101101011110101111100101101111111011110111110111111001100001111110111101111010111101110
00000000000000000001001000000000000100100001000010000010000010000000100000000000000000010000000001000
01111101101101000111010011111001111010010011011111111101110110010110101110111111101010100110011101101
00000000000000000000000000000000100010000000000000000000000000000100000000001000000000000000000000000
11110100110110111110101111100111110101111111000110111011110011011011110111111011001001111011010111011
00000000000100000000001000000010000000010000000000000010000001010000010000010000000000000000000000000
01011111110001111001111101010101111110110111100101010111011111110000010111111001110111111011101000111
00000000000000010000001001000000000000000000000000000100000100000000000000001000000000100000000000000
00111111101111101111010011011110111101111001111011110011110001101111100011111111101101011111011011101
00000000100010000000000010000000100001000000001000100000010000000000000000000100000001000001010000000
01101111110110101011100011010111011011101001111011101111100011011101110110110101101011110101011110011
00100001000000000000000000000000000000000000100000001000000000000001000000100100101000100000000000000
11011101111010110010010110110100101100101111010011110111101101101111101100011111111111001101010110111
00010000010000000000000000000000000000000000000000000000000000000001000000000001000000001001000000000
01101111011011010101111111010011010111101011111011010101101000011111011111111010111101011110101111011
01000000000010010100100000000000010010001000001000000000000000000000000000010010100001001000100010000
10110111111111100001100111001101100111110000100101111110111011110011101101100111100111111111111001001
10100001000000000000000000000000000000000000000000000000000001000000100000000000100000000100000000000
01111111101101010111010111010101001101111110011101111101100111011011101001110111111011110000111111100
00001000000001010100010100000000000000001000000100000001000000000000001000000000000000000000010000000
11001110111011111001110110011011111000111011001001101111110101110110110111001010101101111101101101111
00000010000001000000000000001010000000000000000000000001000100000000000100000000000000001000100000001
01110011111111011110110110101110000111110110110111110111101010111010011111110111001111001111110111101
00000000010000010000000000000000000000000000100000100000001000000000000001000000000100000010000010000
11110110101101001111011101111100101101101011111100101111100111011111010011101011110111011111000111101
00000000000000000100010001000000000100000000000000001000000010000000000000001010000010000000000000100
01111011011101100101100100111111101101101100111111111010111100111101011011101000111101011110101111110
00100000000000000000000000000100000000100000000010000000010000000000001000000000000000000010000000100
11010111101101101111011011101001101111010110110111110110110111011111010010011011111111100100101111100
00010000001000101000000000000000100000010100010100000100010000001000010000000000000000000000000000000
10101111011001111110001111111011010111010111001111011110110101111111101011010110111110110111110101011
00000010001000000010000000001010000000000010000000000100100000010000000010010000000000100001000000000
11011111011011110100110111010001010111101011110010101111010111001101011101111110111111001010111110101
10000000000000000000000000000000010000000000000000000000010000000000000000001000100000000000100000100
11101111110000110010011111100111110000110111101111101011111100011101101101101111011110101111110011110
00000000000000000000000000000010000000000000000001000000000000000101000000000100001000100010000000100
11101101110111101001110010111110111111011101100111101011101101101111101111001111101011001010011111110
00000100000000001000000000000000010000010000000000101010000100100001001000000100000000000000000000000
01111101101011111111100101110110101100101111100110110111011101101100111111001011011100101111110101111
00000001000000010000000101000000000000000010000000000010001001000100000000000000000100000000000100000
11111000000111111111010110110011011110101100011110111110110111011010011111011110101110101111101101110
10000000000000000000000000000001000000000100000000000000000010010000000000000100100000000010000001000
01001101101111111011111110110011001010100111111110010110111100110001011101101100010111011111011010111
00000000000000100000000000000000000000000001000000000000000000000000001000000000000000000000001000000
00111101100110111111001001110111010111111010111110011111101100100001110000111111111000111111010111011
00000000000000000000000000100100010000000010000000000100000000000000000000000000000000000010010000000
01101110011111001001111111010111111110001110110011101101111100111010101011101111101101101111101110110
00000000000000001000000010000000000000001000010000000000010000000000000000100000001001000001000000010
01011011111101010111101110111010011001111110101111011101110011101101111111001111100010001111111011100
00000000001001000000000100100000000000000000000100000001000000000100000000001000000000000000000000000
10001111011011110011100111011111011011001101101111110011101111001111100010101111010010111110110111110
00000000000000100000000000000100000010000000000000000010000000000000000000000100000000000010010000010
01101110111101100111111101111110101011111101100001011101101111101100110101011111011100110011011111110
01000100001000000000100000100000000001000000000000000000000100001000000000000000000100000000000000010
01100111011111001011101100111101011011010111111011111110001101110110110110111011110011111011010111101
00000000000000000001000000000000000010000000010000000000001001000000000100000010000000010010000000000
11110001111011111110001101100101011111100101111101110011101011001011111010111110111011011111010011011
10000000000001000000000100000000000000100000000000000001001000000000000000000100100010000000000001000
11000110001111011110111111110111110100110111111000111101001101111110110111110011100110111011101011011
00000000000000000000000100000100000100000000000000000000000000001000010000000000000000001010001001000
01110111010111011011011111100011101111011011001011001011111011111010111111111000011101111011101111010
00010000000000000001000100000000000100000000000000000000001010000000010000000000001000010000101000010
01111110110011101101101110111111011011011111100110101100100111101110100101111101110111010111011100111
00010000000000100101000100000100000001000100000010000000000000000000000000000000100000000000001000000
01111110110111100001111110111100111011010111001111011011110111110110111101011111100111011111001101110
00000100100010000000000000010000001010000000000001010000100000100100010001000001000000000000001001000
11101111011100001001011101111110010011001111110011111110110111111110000010110110110110110110011011110
00000000000000001000000000000000000000000001000000100000000100000000000000000000000000100000000000000
11110101101010100111011110111011101110110101110011110110111101011111011110111011010011101100111101011
00000000000000000001000000100001001000000000000001000010000100000001000000000000000000100000000000000
11111111111011001010000101001001011011111111101001111110000000011011110111100110111111101111110111101
10000000000000000000000001000000000000000000100000000000000000000000000000000000000000100000100100000
01010110110011111111110011110011110011011101111011110011110010111101111001111100101110111101010111110
01000000000000000100000000000010000000001000001010000001000000000000100000000000100100010000000000000
11100011000111111101100011111101111101011011100110011111101010101100110101111101010111111111111101000
00000000000000000000000000001000001000000000000000000010000000000000000000000100000000010000000000000
11101101111011011001111111010110101111010111001110101011011010111101011111101010111011110001011100111
00001000000010001000000000010010100010010010000000000000000000001001000100000010000000000000000000000
11111001101100011100111010001010110101111011111001111010110111101010101011110110011101101111101100101
00000000000000000000010000000000000000000000000000000000000100000000000000000000001000000000000000000
01010111101111101101111101011010111011111110111011000110111001110011010111110101101110111101111110001
00000000000001000100000000000010000001000000000000000100000000000000000001000101000100001000000000000
11110011011110100110110011111010011110111101010111110101010010011000101111111111111011101111010110010
00000001000100000000000000001010000000000001000000000000000000000000000000000010000010000000000000000
11110110111000011111101101110011111011101010100111111010111101001011101001111110111111100110111011110
00000000000000000100001000000000010001000000000000000000000000000000001000000010000000000000100000100
01011011111011111110001111011101001101110011100111111101100011111010111101110111111101011111111101000
00000000000001000000000000000000001000010000000000010000000000000000010000010000100000010000000000000
11011101110111011110110011110010110111111001011101100011101111100111010101111001010111101101110111110
00000101000010010000100000010000000000000000000001000000000000000000000000000001000000101000000001000
11110101010110101100111110100110111011101011011110010111101110110101110001111101001111011011101111011
00000000000000000100000000000000001000000000000000000010000100000000000000001000000000000001000000000
