00000000001010001001000000000000000001000000000000000011000000000000000000000000001000000000000000000
10010101111101101100101100111011101101111111011010001111111010110111111111000111100001110111101111001
00000000000000000000000000000001000000010000000010000000000000010000000000000000000000100100001000000
11100001111001111001001011111111111011011010101111011111011111011010110101101011010011111001110001011
00000000000000001000000000000000100000000000000010000010000000000000000000000000000000000000000001000
11111001101101111110001111101111011100011011101100001110111101101100110111110110110111011101101001111
10000000001000001000000000000000000000000000000000000000100000101000000000010100010100000001000000000
11010101111101111100111100100111011111110110111101000111110110111001111100110100111111001011111011001
00000000001001000000100000000000000100000000100000000000000100000000000000100100000000000000000000000
11011111111010011000110110111011101111110000111111101001111101101101110110110111111101101011001101111
00000100000000000000000000010000000000000000001000001000000100100000000000010000100001001001000000000
11101111010111011101111001100111110100111101110100110111111011011001111101010111011101101100111110110
10001000000010010000000001000000000000001001000100000000000010000000000001000000000000001000000000100
11011101111100011011111111110111101011101110110101111011011011010101011100010101001101110111111110100
00000100010000000000000100000100001000000100000000010000000000000000000000000000000000000000000000000
11110101101110111010010111011011101000011010111011100101011110111011101111101111011101011110111111010
00000000100010100000000000000000000000000000000000000000000000001000100000100010010001000000010000000
00010111111110111010111101111101110111101011110101011110111010110111101011111100111111010110111011101
00000000000000100010000100000001000000001010000101000100000000000100001000000000100000000100100000000
11011100010111111100010111010111010111110111010110110001011111100100111111101111100101111001110111011
00000000000000000000010000000000000001000000000000100000000000100000000000000100000000000000010100000
01111101111011111000001011110111011110111101110001110111111010011111011101111001111101101110111001101
01000001000010000000000000000000001000010000100000000000001010000000000001000000001000000100000000000
00101010111111101101111101000111111111011111110011011110011000111010111101011110111010110011101010111
00000000000000000100000101000000000100000100000000000000000000010000000001000000010010100000000000000
10111101111001010111101101011111111011111111000001111101111011000001000011101100011110111111110011001
10010000000000010000001001000000000000000000000000000000000000000000000000000000001000001000000000000
10111010110101110111001111101011101110101110110110110111101110111010100011111110110111011010101101110
10000000000000000100000001000000000000001000000000100000001000100000000000000010100000000000000000000
10111110111010101111001100000011111110011101111110011110101110110101111110111110101110001011001101111
10001000000000000010000000000000000000000000000000000000000000100000010000000000000000001000000000000
10110101110111011110101111110101011110111101111101101000111101101111100111101110001100011111101110111
00000000010000000000001000000001001000010001000001000000000000000001000000000100000000000000000000000
10111000111010111110010111010111110010110110011101111101111110101101101010111110100111101001111111001
00001000000000000000000000000000100000000000000000000000100000001000100000000000000000100000000000000
01101101010111110111111001101111110111111010110111011010110111111011100011011010111011111111010111011
00000000000000000100000000100000000100000000100000000000000010000010000000000000000000100000000100000
01001111001101100011111110110111110110111110001111001110110011101010111010111011101111101101011010011
00000000000000000000000000010000000000000000001000000100000000000000001010010000001000000000000000000
01101011110110111101001001111111111001011111111110000110111110110011001011000011111101110001111111011
00100000010000000000000000000100000001010000000000000100000000000001000000000000000000000000000000000
10111111011111000011110111101011100110111011011010111111101110001110111110110111011011000101110001111
00010000000000000001000000000000000100001001010000001000000000000000100000100000000000000000000000000
01111111110101010101110011111011101011111111011011101101110111111110001101101111011111100111011001110
00000100000000000100000000000001001000010000010010000001000010000000000000100000010000000100000000000
11110001011111111111001010001011101101111100100011101111111110011110000110110101110111010110010111110
00000000000100000000000000000001000101000000100000000000000000000000000000010101000000000000000001000
11111100101111010111011111100011111011101001110101101110100100110110111011010100110010110111110011111
10000000101000000010000000000001000000000000000000000000000000010010000000000000000000000000010000000
01111011110101101001101111110100111111101110111110001110100111101111111110101110100111001001001101011
00010000010100000000000000000100000000001000000000000000000001000000000000000000000000000000001001000
01101110110111110111011001101111110001111011101111001011001011111101111011110101111011011010010111110
00100000010001000100000000000010000000000000000000000000001000001001000010000000010001010000000000010
00001011101110111111111110000011111101110110111011011111001101011110111011101011000101111111011111110
00000000000000000000100000000000000000100000000010000010000000000010010001001010000000000010000100000
11100110111011101011110001011111100011111101101100101111011111101100100111001111101101101101111110001
00000000000000000010000000000010000000000000000000100000000000000000000000001000001000100100000000000
10100111101010110101011111101110010111100011101101111111001111111010001101111101011111101100111101010
00000000000000000000000000000000000000000010000000010000000010000000000000001000000100000000000001010
11110101100111100010111111100110011011111101011110101111010010110111101011111011001001011100111011111
00000001000000000000000000100000000000000000000000001000000000000000001001000010000000000000000000000
11101000111111110110101111010101111011100101101011111111101011111110110011010101111111000010101110111
00000000000001000000100001010100000000000100000000001000000001000000000000000100000000000000000000000
11011101111010111111001111101100101110110111011110110100101110110111001101010110111111111000101110111
00000100000000001000000000000000100000000001000000000000000010100001000000000000000000000000000100000
11110010101001011011010111011110110111101111101001100111101101011011011111011111001110011101110111101
10000000000000000000000000000010010000001000000000000000000000001000000010000000000000010000010000100
11111111000011101111101101101111001011111010111111011101000101011111111101000110111011001111011111110
00000000000001000001000000000000001001000010100000000000000001000010000000000000001000000000000100000
11100111101011111110011101101100100111100110101111011111110010110110010001101010110101110111101111101
00000010000000000000000000000000000100000000000000000000000000000000000000000000010100100000100001000
01111011011101110110011001111110110001110111111101000110010111011101110011110111010111101011111110111
00100000000001000010000000000000000000000000000000000000000001000000100000000010000000100000001000001
01010010111010111100111100111110011101011011100110111111011111100111110110111111011110011101101110001
00000000000000000000000000000010000000000000000000000100001000000010000010000000010000000000000000000
01111001111101111111001011010101011011111110011101000010100111111111111101001001011011111010011111101
00000000010000100000000010010101010010000000000000000000000000010000000000000001000000100000000010000
11101011111010111011100110101111011011110111011001111111101110000101101101110111101101110111011101011
10001000100000010001000000000000000001000000000001000000000000000001000100010000101001000001000000000
00111011111101101010000111101101111100110110101111100111111011110001111111101101111101110101101110111
00000000000000000000000000000100000000000000100000100000010000010000000000000001000001000000000100000
11011011111101001111011111011011011010111111011110001010111110110110111000110011111101011111001110011
00001000000000001000001000010010000000000000000000000010100000000100000000000000001000000000000000000
11101110100111011110101010011011110111011011100111011101001101010010100001111111111101110110101110101
10000000000000000000000000001000000001001001000000000001000000000000000000000000000000010100000000000
01110001111101111101010110111110010111010101110111101001111101011011111110101010111100011011111100101
00100000000000001001010000000010000000000000000000000000000000010001000000001000000000000000000000000
10101111101000111111100111001001110111101001111100110111110100101111011001111110110111110111011001101
00000000000000001000000000000000000000000001000000000100000000000000010000001000010001000000000000000
10101100111110111110111110100111010111000111011101011110110110101111100010111111001011011101101110111
00100100000010000010000000000000000000000000000000010000000000000100000000000010000000000000000100001
11111011000010111111011011111010101111010011011011110110111110101011111010111111000111010011111110110
00000000000000001000000010000000100000000000000000010100000000000001000000000000000100000000010000100
11011110110011110101011101111001110111110011101101110101110110110110110011110101111101001111011111011
00000100000000010100000000000000000010000000000100000000010000000000000000100000000001000000000100000
01111001000111100100001110111110101111101101111101001010111010111101111101010001110111110101011000101
01000000000000000000000000000000000000101000000000000000001010100000000000000000000000000000000000000
11010101001111011110011101111110111010111101011010111110111011011101011111011010111111101001011101110
00000000000000000100000000001000000000100000001000000100000001010001000001010010000000000001000000100
01111011110101110101101011001011111101110111100111111011101101101011101010111011111111100000100111011
00001001000000000000100000000000000000010000100000000010000000101000000000000000000000000000000000000
