00000000000000000001001000000000100000000100000000001000000010010000010000000000000110001000000000000
10011011010111011101100111111010010111110110110111010101110111011111101111101011101101100111011111110
00000000000000000100100000000000000000000100100000010000000000000100000100000000000000000100000100000
00111011110111011101011110101111101000111011111011100011011110010010110111101110011010110101100111011
00000000000001000000000100000000001000000000000000000000000000000000000000000000010010010100000000000
10101111010110111111110111101010101101011101101011110111111111010001011001101111010111011010011111101
00000000010000000010000010000000000000000000100000000010000000000001001000000000000000000010000000000
01111110011101011111101010101111001110110110110111011111100110111111101010110111111011110101111011010
00000000000001010000000000101000000000100000000010000000000100000100001000000000100000100000000000000
01101111101111010100101110011001111111011100111110101011011111101111011111100111101010101110111001101
00000001000000000000000000000000000100010000000000101000000001000010000000000100000000000000000000000
00011101101111101111110110001111010110011111100101000111111101111001011110001001110111111001100111111
00000000000000000100000000000100010000000000000000000000001000010000000000000000000000001000000000000
01111101111011111111001001011011101010110111100110011011111110011010011011111101011101111010110101110
00000100001000000000000000000000000000100010000000000000000000000000010010000000010000100000000000010
01101111011100001100111011111011101110111110011111011101011110111101111101111101011111001111000110110
00000010000000000000000000000000000100000000001000001000000010000000100000100000010000000000000000000
11111101101001100101111110100111110010100111111110111010110110111110101101111111001111111001100111011
10000000000000000000010000000001000000000000000100000000000100010000100000000100000000000000000100000
11101110011011111110111111110001011101111101110101011111101110111010111001011011110101010110111101101
00000000001000001000010000000001000000001000010101000001000000000000000000000010000000000010000000000
10011111100111001111111011110100111111001111111011011001111100111010001110101111001001111101111101011
00000010000000000001000001000000000010000000000000000001000000000000000000000100000000000100001000000
11110111100110111011010101101111110101011101011010101100111101110110111101110111101111110110111010001
10000100000000000000010101000100000101000000000000000000000000010000001001000001001000000000000000001
00111111011000001110110111111011101011111001011011110111111101010110111000111111010111010011111111100
00000001000000000000000000000000001001000000000000100001000000000000010000000000010100000000010000000
10111111111001001001100111110110110110011101111011101110001110101010100010101010111101101111111101110
00000000000000000001000000010000000000000000000000000000000000000000100000000000000000000000000001000
10110101111110111011101111011011000110110110111110010111011111010101111111010101101101100111101101110
00010100000000100000100010000000000000000000000000000010010000000100001000000000000000000000001000010
01010111110011110111110001101111011011011011101011101010101010111101111111000101111001010011011011110
00000000000000000100000000000000000010000000000000000000100000000000000000000000000000000000010000010
10101110111001011111001111010110101101110100111101111101100011110101101010111111011011111001011101110
00100100100000000000000100000000000000000000000100010000000000000000100000000001000000000001010000010
10111010011000111111101010011110101111011001110001111111011110001011111110100101011101111110101101110
00000000000000000001001010000000000000010000000000000000001000000000000000000000000000100000101000100
10111010101000111111111011001011011101001011101100011101011110110011100011101011111110011101111011101
10000000000000000000000000000000000000000000000000000000001000000000000000000000010000001000000001000
11011111110010111110110110111111011101010111001111111101001101011101011110111111010101101101101101011
00001000000010000100000010000010001000000000000000000000001000000100000000001000010101000000000001000
11101010101111111101111011110111011111101110111001111100111111100101111011011011010111110011011111110
10001010100000100000100000100100000100001000001000000000000010000000000000000001000000000000000100000
10110101110110111101101101111001111011101101100110111110111011110100010011110110110111011110000111111
00000000010000000000100000000000100000000000000000010000100010000000000000000000000001000000000000000
01001110111101111101111011110111101001101111011100011011111001111010111011110101111001101001011111011
00000000000100000100010000010000101000000000001000000000001000000000000000000001000000000000000000001
01110110101011111101010110011100110101101111111011011000110111111111000001010111110101111110111011010
00100000000000100000000010000000000000000000000000000000100000000000000001000000000000100000100000010
01111101101111101110011011111101010011110011111010011110101101001101111111010110100111111100110101110
00001000000100000000000010000000010000000000000000000000000100000000000000010100000000000000010101000
01110111101100111011101110011111110010111100101101101111000111111110110001110010111110110111111001101
00010000000000010000000010000000000010100000000000100100000000010000000000000000000100000000000001000
10110111011101011010110111011110111101111000011111101101011101011111110100110101110011011110101011101
00010000000000000010000000001000010000000000000010000000001001000100000000010100010000000000000000100
11110111110110101110011111111100001000111100101110011111100111111011101011110111110110110011111111110
00000100000000000000000000000000000000000000001000000001000000000010001000000010000000100000000100000
11001111010111100111101101111011100001100111111111101011100010111011011010101111111011011011101011110
00000000010100000000100000000000000000000000010000000000000000010000001000000000100010000000001000010
01011111110110101100101101110111111001101010110111010111111101011001011101111101011110101111011110110
01000000000000000000101000100001000000000000000000000010000000000001000100001000000000100100010000000
11100101011111111011000110101110011110110000101111111111010111111101001010111111110001001111110111110
00000000000100000000000010100010000000000000000000000100010000000000001010010000000000000010000100000
01101110011010111011011101011001111101011100111110000111111110110111011011011110011011111101110111101
01000010000000000000000000000000000101000100000000000000000010100000001000000100000000000001000001000
11110011011101111101111011011101110111101110110110011010111011000001111111110110110001111101101011110
00000010000100000101000001000100000001001000000000001000000000000000000000000100000000000000000000100
00111111011110010111110111010111111010010111011110111011011110111111100011011110101100110111111000111
00000010000000000001000001010000000000010000000100001010000100010000000000001000000100000000000000000
11101101010010111111101011111010101101111011011101111101011001001011111000111110111101010111111001011
10000100000000000000001000000010000000001000000100000001010000000000000000000000000000010000000000000
11110101101101011101111111001110011101101110010001110110010111110110100111010110111010111011111011110
00000000000000010000010000001000000000000000000000000000000000000000000000010100000010000000010000000
11011101001111011011111110111101110111001110111001110110111001110110111011011110111111000101111010011
10010000000001000000001000010001000000000000100000010000001000000000001010000000100000000000000000000
10011101101101011011110111011011010111011011011111011101101001011110100101111001111100010101010111110
00000000000000000000100100000000010000000001000001000000000000000000000000000000000000000000000000010
11100111101110111101001011011111101101001111011101110011010111111010111111011111001101101011011110110
00000010000010000000000000000010001000000000000001000000000001000000001000001000000000000000010000000
01100010011111110111011011101101111110011011101011111101010111111001010101111101101100110111110111011
01000000000000000000010001000101000000010010000000100000000000000000010100000000100100000000000001001
01110110111101110111111001110110111110101111111101010110110101111110010011111110011110111110011011111
01000000001001000100000000100000010000100000100000000000100000000000010000000000000100000000001000001
10111101110010111011101010111110110101101100111111110101110111110110100110110110011010011111001110111
00000000000000010000101010000000010100000000000001000000010100000000000010010000000000000000000000000
01111110010101001001101001100111111101111110101100110101111110011101101010110011011110111101111111001
00000000010100000000000000000000000000000010101000000000000000000000000000100000000000001000010000000
11010111100111001111111111010011101011111010011111110110101011110011110110010111101111101110110110001
00000000000001000000010000000000000001000000000100000000000001000000010000000000000010000000000000000
00110010111101110011111011110111010100111011011011011111101101101111111111110000011011010111110111101
00000000000000000000001000000010000000000000000000001000001000000100000000000000000010000001000010000
01110111110111111010011010110001111101110111011011011100010110101000010011111111111110010101010111111
00000000100000000000000000010000000000010010000001000000000000000000000000000000000010000000000000000
11101100001001111111101011111010111111101100011100001111101000101111110101011011111100101011110010101
00000100000000000000000000000000000000000000000000000000000000100010000000001010000000000000000000000
00011101111111001011110101011101011001101011111110110111101101101111101001100101110111001101111110110
00000000000000000000000000010000000000000000100000100000000001000001000000000000000000000000001000000
01010111111101010001011001111101100111101100011101111111110100101101111010001100111101101110100111111
00000000000000000000000000000000000000100000000000000000000000001000000000000000000000000100000000001
11011101111110111001010011111010111110101011111101101110111110100111101101110110101101100111111101010
00001000100000000001000000000000001000000000100000000100000100000000000000000100100101000000000000000
