00000000000000000001000000000000010000010100000000000000000000000000000100000000000000000001000000000
10110111011001011111101110011110110111110001101111100101111010010001010111011111111001111101011110110
00000010010000000000000000001000000000000001000000000100001010000000000000000000000000000100000000010
11101110011111100011101110111111011100110111011111001101110101111111000100111111110011011010011101110
10000100000000000000100000000100000100000000000100000000000101000000000000001000000000000000001000010
10001011100011101111011110111010111100110101111110111111011011010110111100111110001111010111110001011
00000000000000000000000000010000000000010000000010000010001001010000000000000000000100000000000000000
00111111011110100101001110000111110011011010011111111110111111100101001011011111001101011110110110110
00000000000000000001000000000000000000000000000000001000000000000000000010000100000000000000000000000
01101010111110110101011101111011010111111101001111010011001101100101111011001011111010101101111101101
00100000000000000001000000100000000000000000000000000000000000000100000000000000000000101000010000000
11111011100010110011110001111100011111001101111100111111011110011111111100011100111011011110111111101
00000000000000100000000000000000000000000100000100000000010000000100000000000000010001000010000010001
01101111010011011010111101110110011111101011101010110111110011100111111111100011101111101111001110110
00000000000000000000001000000100000000100000000000000000010000000000010000000000000100000100000000000
01101101111011001111010111011010111011100111011110111101111110011111010111111011010110101111111101101
00100000010000000000010010000000001010000001000010000000010000000010000000010010000000000000100000000
10011111110011011110111011101110110100100111111010111111011110111011010111111111101101001011101110110
00000010000000000100000001000000000000000000000010000010000010001000000000100000000000000010000000000
11100010111111111011001000111101111101100101110111010001011101111110001111100111100111011111101100011
00000000000100000000000000001001000000000000010001010000000000000000000001000000000000000100000000000
11110110101010101111001111101011001111101111111101010111100001101011011001011110111010101001001110101
00000000000000000010000001000000000000001000000000000000000000000000000000000000000000000000000000100
11101101010010001111110011101101011110110011111010110111000111110101110111101111011001011111101101010
00000001000000000000000000000000000000000000000010000000000000000000000010000010000000000000000000010
11011110110010111101011110101101100110111001101011101110110111110011111011100101100011101111110101101
00000000000000010000000000000100000000000000000000000000010000000001000000000000000000000001000100100
01101011111111110001110111001100111101110110010110101010101111011110111101010111101111110011101011011
00000000010000000000000000000000100000000000010010000000000000000010000001000000100001000000000001000
01111110100101101101011111011100100111111010111010111100010001011010011101110111111011001101111001110
00100000000000000100000000000000000001000000000000000000000000000000000000000000010000000000000000010
00011101111111110101100111111110010110010111110101101111111111010000010111110101100011101111111010001
00000000000010000001000000000000010100000000000000000100000000000000000000000000000000100000000000000
10111101001011111101101100000101101011110001010111111111111100110101011100101111100111001111110111101
00010001000000000100000000000000000000000000000000000000000000000101000000000000000000000001000001000
01110110110111110010111001111101011001101111110110111101110111111011010111011110101101111011001110111
00000000010010000000000000001000000000000000000100000100000001000001000000000010100100000000000100000
11111101011111011110001000101110111110101011011101101101110100101011111101111101110111000111000110101
00000000000000000000000000001000010000001010001001000000000000000000001000000000000000000000000000000
01111111111101100001001101110101101111000111111110101011010010111111111101010011110101111111110011101
00000000000000000000001000010100000000000000100000000001010000000000100000000000010000000100000010000
01111110110001110111001110110111101011111001111111000111001111111110011111110011100101101011001111011
00001000000000000001000000000001000000100000010000000001000000001000000100000000000000000001000000000
11010101001101011011111001111001100001111111101111000011110111101001111111100111111110101111101101010
00000000000000000000010000000000000000000000100000000000000000101000000100000000100000101000000000000
10110101011010010101111101110101011110001111011101111100101001111011110000110011110110110110001011111
00100000000000000000000000000000000000000000000000000000000000000000000000000010000000000100000000000
00010011101101111111101011111101100111101111110001111011011100011101111101101011001001101111111000011
00000000000000000000001000000000000010001000000000100000000000000001000000000000000000000100000000000
00001111001111111101101110110101111100111011100011111110011010001101100111111110100111110101111111000
00000000000000000000101000000101000000000000000010000000000000000100100000010000000000000001000000000
10110110110011111101010110110111111001111011010111110001111010111011111110110010110111101101111101011
00000000000000100001000000000001000000000000010010000000001000000000010000000000000010000000100000000
01100111111010101010011110111111111010111110111010111011111000001111111100111001111111101101100101101
01000000000000100000000000000010000010000100100000001000000000000000000000001000000010000000000000000
11110111111001101110100111111100111110011111001110001111111001101111111011101101100110111101101110011
10000100000001000000100000000000000000010000001000000000010000000000100000000000000010000100101000000
11011111010001110101110101111101110111110101101011110010001010111101110111110011111011110111111001010
00000000000000000001000000100001000000000000000000000000001000000000010100000000100000100000000001010
11010111111100110010001111011110110001111101111011001111101001101001001101001111011111101111011011110
00010000000000000000000000001000000000000001000000000000000000101000000000000000000000000010000000000
01011111100111010011110110101111010011111101101010010101111110111101111001010010111110111101100110110
00000000000001000000000000000000000000100000101010000000000000001000000000000000000010100000000000000
01110111010101111011101111001111110011110001111011111100100001001100110011100011111111001110110111101
01000000000000100010001000000000000000000000000000000000000000000000000000000000001000000000100000101
11111011111010100011000101111111000010101111101111011110011011011110011100110000111110111001011111010
00000000000000000000000000001000000000000000000000010000000000000000000000000000000100000000000001010
10101111110111010110110000111101101111110011111111101111111110100000101000011001110010111101011111011
00100000100010000000000000000000000001000000000000000000000000000000000000000000010000000000000001000
11010101101110110011101111011001111011011101110000111111111111110011001100111111011110101011111010011
00000000000000000000001000000000000010010001000000000000010000000000000100000001000000100000000000000
01111101011111101001011100111111101011011111010011111110101111110111011101101111101110011101110101011
00001000000000000000000100000010000000000100010000000100100010000000010000100000000000010000000000000
10110111111100111100000010011111111111111101101010110110011111011110011011101100011111110110110000111
00000001000000001000000000000000000000100000001000000000000001000100000000000000000000000000000000000
01011011101100111110101011111100111010011100111101011111110100110101011110100111101101101011010111101
00000000000000001000101000000000010010000000000000000000000000000001000000000000000000000001010001000
00111110011111010001011101110101011111011111001110100011111111101110111101101110111011010011011010111
00000000000010000000000000000000000001010000000000100000000000001000001000101000010000000000000000000
01111101111011101010101111010110100101101111101111010110111011011101011011011011011011110111000101101
00000000100000000010100000000000000000000010001000000100010000000000000000010000000000000000000000000
11111000111101011011110011011100110111011101111010100101111011011110011101100110110011111011011101110
00000000010001000000000001010000000000000000000000000100000010010000000100000000000000000000001000100
00111111110011101101110111000111101111011110110111001101101011011110101100111101010111100100111110111
00000000000010000001000000000000100000010000000000000000000010001000101000000000000000000000000100000
10110111011011011011101101111110101101111101011011011110101110110111101111010111101111011001110111011
00010000001001000000000100010000100000001001010000000010000000000001000010010000000100000000000010000
11011110111010001111111011101110111101110000111011101111011011101101110110111010111101111101101111001
00001000000000000000100000000000000000000000100001000010010001000000000000010000001000001000000000000
11100111110101011110111110111111010101111101110110001111010011110110110110111100111001111110111011011
00000010000100000010000010010000000001000001000000000000000000000000010010010000001000000000010000000
11100111111101111101000111011101110010111011111011101011101011010011111011001100001011101101111101111
00000001000000000000000100000000000000000010000010000001000000000000001000000000000000000000000000000
10111010010111110111011011110001100111011100110101101111101000111111101010110110110101111100011111001
10000000000000010000000000100000000000000000000000000000000000000010000000000010000000000000000000000
01101101101111100111010101010001011011111011110111011010101111101101111110011100111111001101001111101
00100100000000000000000000000000000000000010000010000000000001001000000000010000000000001000000000000
11001110101111011010110111110011101110011111011110000011011010111101111010110111011001100100011101110
00000000000010010010000001000000000000000100000000000000000000000000000000000000000000000000000000100
10111010111110011100100101111011101110111011100110101111011011101101011110110011111011100111101111110
00000000001000000000000000000000000100000000100000000000000000000001000000000000010000000000100000000
