00000000000000010000100010000000010000000000001010010000000001000100000000000000000000010000000000000
11010101111110101101001111010010111101110111101101111110111010101100111011111011110110110101100111011
00000000001000000000000000000000000100000001001000001000010000000000000000010000010100100000000000000
01011111101101111010111101011111000100001111111100111111000011011111000110001101101110110111111011101
00000000100100010010000000000000000000000000010000000000000000000100000000000000000000000000000010000
11011111110011011110001101110111110011111010111011111010010111110110101011110101011111100101111101011
00000100000000000000000000000100000001000000000010000000000000100000000000000000001000000000100000000
11110010111101110001111110111101011011011101110101111011101101100110110101111101011101111101010111101
00000010000000000000010000010000001000000100100000000001000000000000000000000001000000010001000000000
01100011011101011001101111100110111110111011110101011111001111010011010110111011101111001110110010111
01000000000000000000000000000000000100010000100000000010000000000000000000000000001000000000000000000
10111010110011101101111110110111101011011100101011011110001101111110101011111101111010111101110011101
00000010000000000000001000000100000000000000001010000000000000010000100000000001000010000000000000100
10101111001000111111011011011111101111101101011101111110110110111011010111011001111011010011101010110
00000001000000000000000000000001000000001000000100100000000100000010010000000000000000000000101010010
10111111011101110011101001110111101111111001101101110011101111111000011101101101101111111100110000101
00000100010000000000000000000010000010000000000000000001000000000000000001000101000000000000000000000
01010110111111011001110011010110101110111101101101110101101111101010001111110110111011011101111101001
01010100010000000000000000000100000010000000000100000000000100000000000000000010100001000000000000000
11011101110001110101001110110101111101111001011110111101100111011010111111101111011011110111011101101
10000000100000000000000000000000000000000001000100000000100000000000000010000000010000010100001000100
11111010111010111101010110111010100011011001111111011011101111110110110111101011110110010111110101110
10000000100000010000000000000000000000000000000000010000100001000000010010000000100000000000010101000
01111100101111101111011110101011001110000101110110100111011111101100111100110110111011111011110011101
01000000100010000000000000000000000000000000000000000000010000000000100000010100001000000010000000101
01001111101111001111011101110000111011011101111010010001011001010110111101111111111011111011100100111
00000000000100000000000000000000000000001000001010000000000000000000000000000000001000100000000000000
01110111111010011111101101011011011111101001100001100111111011111110101011011111101110101011100101111
01000001000010000001000000000000000000000000000000000000010000010000000001000010001000000000000000000
11001111100101111011010111010101011110111100100111111111011010001011110010101011101101101000111111101
00000000000000000010010000000000000000000000100000001000000000000000000000000000000000000000000000001
11001011111011100101011100100111111101011011011000111111111011100111011111101110011110101110110111101
00000000000000000001010000000000010001000000000000000010000010000001000010000000000000001000010010000
11101100111110011111101101011101101110111011110110111011101101111101111010101111101111101011111011011
00001000000010000001001000000000000010100000100000001000000100000101000000100001000100001000001010000
01110111011111010111101110011111110010111011011001110101011110101110110101010011101111111101110111011
00000010010000000100000100000000000000100000000000000001010000000000100100000000000000010000010001001
01110010111011110011111101101110010101111001011011111111010110011011101110100111111111011100011110110
01000000000000000001000000000000000000000001001000100000000000001000000000100000001000000000001000000
11011110111100101011011001101101111010101111101111111110111101000101000010010111111011110011111111001
00010000000000001010000000000000010000000000001000000000000000000000000000000000010000100000001000000
11011011111011010101110011111101010011111101101111011101110101111000001011111110110111110100111110111
00001000100000000000100000000000010000000100000000010000000000000000000000001000100010000000000100000
01111110001011110110010111111001100101110111110111101111011011010011111011010010111011111101110110110
00010000000000000000000000000000000000100000100000000100000001000000000001000000000000001000000000000
11010101111011001111011110111110010111111011011011110011111111010011111101111010100101111101100111111
10000000000000000100010000010000000001000000010001000000001000000000100001000000000000000000100000000
10101111111011010100110001001111110111011100011001100001110101111100110111111111100001110111110111011
00000000000000000000000000000000000000000000000000100000000000000000000000010000000000010000100001000
00011001101110111111101001111011001101101111001111011010011111001011101101100011111110011010110111110
00000000000000000000100000000000000000000000000100000000000000000001001000000000000000001010000001000
01110111011101011011110111010110101011111011110101101110111110001011110111111111011010110000111001111
00000000000001000000000000000000001000001000000000001000000000000001000001000000000000000000001000000
01111111100111001111100011100110111110110010101111110111011100110111001111000011111111011110100011111
00100000000000001000000000000000000100000000000000010100000000000010000001000000000000001000000000000
11101010110101111101011111110101110010111011101111110011010111011110111110011111011001110110111101110
00000000010000001001000001000100000000000000001000000000000100000100000100000000000000000100001000000
10111111001011011110110111110101110100011011111111101011111101101101111100110100111011011001111010110
00010000001001000100000000100000000000000000000100001000000001000101000000000000000010000000000010100
11010111110101110110111100111011110111011101011111100111011011011101111110111001110111011101010110101
00010000100000000000100000010000010100000000001000000000010001000000010000000000100000000000000000001
10011011111000111111010010101110011000100001101111011111111011111001101010011101011100100011111111110
00000000000000000000000000000010000000000000000000000000000000000001000000000000000000000000000000000
11101010011011111110001011010101111101111101001100111001110111111010011110011111010111101010111110101
10001000000000000100000000000000000000000000000000000000010000100000000000000000010010001010000100100
11001011111011101111010101101101011001110000111011111011011110001111101010111101100110111100011011011
00000000010000001000000000000000000000000000000000001010000000000000001000000000000000000000000000000
11011110001110111110011111001011101101111110101111011011101101011110101110111011011011011011111100001
00000000000000010000000000001000000000100000001000001000000101001000101000000010000000000000000000000
00011110100011110110110011101001011110101001001111101110011110011010110110110111110110111101101110101
00000000000000000000000000000000000000000000000000000000000000000000000000000001000100001000000000000
01111111010010110111011011111101110110010011011111111110101110111110110100001100111110110101011011110
00001000000000000000001000100000100000000000000001000000001000000000000000000000000000100000000000000
11011011010011011101110101111010011011011100001111100111011100110110110011001111011101011100110111011
00000001000000000000000000000000000000000000000000000000000000000010000000000000000100000000000000000
01010011001111110111101100011011111110101111101011111000110111011010101111001011010101111011010011111
00000000000000000001000100000000000000100000001000000000000000010010100000000000000000000001010000000
11010101110111110000111110111101001111011011110111101110011110101001101101111011111011101110110011111
00000000010000000000000010000000000000010000000010000000000000000000001000000001000010000000100000000
10111101111111011010110010011011001011000111010111111010101010111110011101010111111001101100010111110
00010000000000000000000000000000000000000000010000000000000000100000000000000000000000000000010000000
01001111010111110101110111000111111111110011010110111011111101001110111100001101111111100101111111001
00000000000000000000100000000000001000000010010010001000100000000000010000000000000000000001000000001
11100111110110111001011010111111100100011111111001110110110111111101010010111100111111011111001110101
00000010000000000000010000000010000000000000000000000010100000100000000000000100000010010000000000100
11011011100111111001110101110100111110010111111001101101110011111101100110111111001010000011110111110
00000010000000000000100000000000000000000010000000000000100000000000000000000000000000000000000010000
10101100111010111101010111111111100100011101100001110111101111001010111110111100111100000111101110111
00100100000000000101000000000000000000001000000000000000000000000000001000100000010000000000000000000
10111011101111011101110101001011111101101110111101101110100101111111000011111101100111111010110111110
00000010000010001000000000000000001001000010000000000000000100000000000000100000000001000000000100000
01111011011111111010100011110110011101011101001110110111110111011101111101011111001010110101111110101
01000010000100000000000000000000000000001001000000000000000100000000100000000000000010100000000100100
10101110111110101010101111111010101011111111100010101010111110011011110110100110010011110111100110111
00100100010000101000000000100000000000100000000010000000000000000000000000100000000000000000000000000
11101011101111110011111010111110011010111011101111010011111010111010011110111101010110101111111101010
00001000000100000001000010000000001010000000000000000001000000010010000000000000000000100001000000000
10111101111110111101011100011011101001111100111110011101110110110111000111011011011111111110000101101
00000100010000010001000100000000000000000000000010000000000010100000000000000001000000000000000100100
11011000111101101111111100101100010111101100001111011101101101100101110110011101110110111001011101101
10010000000000000000000000000000000000000000000000010000100101000000000000000000000000000000010000000
