00000000000000001000111000000100000000000000000000100000010000010001000000001010000000000000000000000
01101010111111010111110110111001111000111011111101010111101011001111110111101011101111101010011111110
00000000000010000001000100000000010000000000000000010000001010000001000010000000100000000000000100000
01100111011110110111100111111101011101110111101111011110111111101000100111110110111111011111001100111
01000000000010100000100000010000001000100100000100000000100000000000000000100000000100001000000000000
11000111111101011110110101110111111011101111001001101110101100100100110000111011011010011110111010111
00000000001001010000000000000000000000000000000000000000000000000000000000010000000000000000010000000
01110111101110101011111010110111101011101111000101111111001011101101100111100111111110110011111100110
00000000000000000010000000100000000010000010000000000000000000000000100000000000001000000000000000000
01111101110111001001111110111110101011011101010111101101011101111000110101111111110010011110111110110
00100000000100000000000010000000000000000001010000000000000001000000000000000000000000010000010000000
01011010100101011110111001110110111100111110110011110110101010111111001111100111111001111101101101001
00000000000000000000000000000000001000000100000000000000001000000000001000000010000000100000000000000
11010111011111011010011101101101111011101111011101101110011110111001011111001011110111111101011100101
00000000010000000000000100000000010000000100001001000000000010100000000000000000010000000000000000001
11101010110101011010111110011011111010101111111001110011111011101111011101101001111101011011101110110
00000000000000001010100000010000010000000000100000000000010000100010010001001000000000000000101000000
00111011111101111110100110110011011100101010111011001110100110010111111010001011111111111111110001100
00000000010000000000000000000000000000000010000001000000000000000000000000000000000001000000000000000
10101101101111011110111000011110100110111110111110111110111010011110011110110010111111111010110011110
10101000000001000000001000000000000000000000000010000100000010000000000000010000000001000000000000100
10111011111000011011111101101101111110101111001011100010101110111111001111100111001111011010110111011
00000000000000001000000001000100010000000100000000000000000000000010000000000000000001000000000001000
10111101110010011011111111110110011111111101001111011101110111110111100111110000011101101111011011101
00000101000000000000000100000100000001000000000010000001000001000010000000000000000000000001001001001
10111101101100011101111101110001001111100111100111111101001011111010111111001111101010111110101111011
00000000100100000000000000100000000000000000000000001001000000000000001000000010000000000100100000000
11101010111110111111110100011101111001001101011111010111100110111100011110111011001111011110111011110
00001010000010001000000000000000000000000100000000000000000100000000000100001010000000001000010000100
11010011011110111011110111101000111111001001110111001111111111010001111110110011111111011011101101010
00000000000010000000000000000000000000000001000100000001000000000000010000100000000100000000000000000
11100110111011111101011100101101110010111100111110110001011111110010110111010110011010111011111010011
00000000010000010000000000000000010000000000000000100000000000000000000000000000000000010001000000000
01010111010111110110111110111011101011011111110101011100101110111100100101111111111000101111011011110
01000000000000010010000010010010000000001000000000000000100010000000000000000100000000000010000000000
11111010110101111010111111111001011111101100110101111101110111011111110011011110111101011011101101101
10000000000000100000000100000000010000000000100100010000000100001000000010000010000000000000101000000
11000110011011010111011011111010101111111011111001111011011101101010000001010101101010111111011100101
00000000000000000000000000010010000000000000000000000000000000000000000000010000000000000000000000000
11110100111111110011100011011111101110110110111110101110110111000011101100111111111011010111011111010
00000000001000000000000000001000001000010010000010000000000010000000000000000000010000000001010000000
10100111110001111101110011111001110110110111010001111111101100110011101101100111100101101011111011101
00000000000000000000100000000000000010100010000000000000000000000000000000000100000000000000100010000
11100111111101000110111111011101111101011110001111100101100011111010110101110111001101111111010111000
00000010000000000010001000000001000000000000001000000101000000000000000000000000000001000000000000000
11101111110101011111011011011111001111011101010110110111101111101111000101101110110111011101111110010
00000100000100000000010000000100000000000000000010100010000010000000000000000010010100010000000000000
11110100111110001110101100111111001111011011011110111101110111010111111100011111101111100010111101100
00000000000000001000000000000100000000010000000100000101000001010000000000000100000000000000000000000
00111010011001011111101111111111110000110011110001001001111011010111001101111101111011111010000111111
00000000000000000000000000000000000000000000000000000000100000010010000000000001000001000000000000000
11010001111110111111111001100011011011011100100111110011011111100111011101101100101011101101111011110
00000000000100001000000000000001001010010000000000000000000010000000000000000000001000000000000010000
01011101001111111011101010101101100101111010110111101111101010100101000111101110011110011101100111010
00000000000000000000000000000000000001000010010100000000000000000000000000100000000000000000000010010
11001111010110011011001110011011101101101111101011101010111111011111001011011111100101011111011001011
00000000010000000000000000000000000000000100000000101000000100000000001000000000000001000000000000000
11101111101101100010110101101011110111010111011111110111000001101111101111111011110110110101111011101
00000000000000000000100100100000000010000000000100000000000000000000100000100000100010100000000010000
10111011011110001111100111111111001000111001101011111100110111101110011100001111111101011111110101100
00000001000000000000000000000000000000000001001000000000010100001000000100000000000101000100000000000
00101111110110111001110110111001110110001111111101100100011001111110101111010101111101101011011101111
00000000010000001000000000000000000000000001000000000000000000000010101000000000010000001000000100000
11011110110010101111110011110110001011111100011111101000110111111111011101101010110110101101010100101
00001000010000000000000000000000000000000000000010000000000000010000000000000000000000000000000000001
11011101101101101110111000011111110111111011011111010001100111110101101111011101111011101110110011110
00000000001000100100000000000000000010000010000000000000000000100101000001000000010001000100000000000
01111111011011011011011010101110101000101101011101010100111111111110111110101100111111011011011110110
00000100000010000001000000000000000000000000000000000000000000000100000100000000000100000010010000010
10011110011101101111011111101110111101110110100111001111100100101110000111111111101101011110111111010
00000010000000000001000010000000100000000100100000000000000000000000000000000000101000000010001000010
10111010111111001100110111111011111111101101110111110011110100011001010010011111111111001111011011101
00100000001000000100000000001000001000001000000100000000000000001000000000000000000000000100000010000
11111100110110111101101011011111111100100101010110111011111101101101011111111011011110111110011101010
00000000100100000000001000000100000000000000000000010000100001001000000010000000010000100000000001010
10111110110111110111001101110101000111100001111111101010001011111110111111010101011110101110011111101
10010000100000000000001000000000000000000000000000000000000000000010010000010101000000101000000001001
01101111011111011111001111011111101110000101011011011001111001110110100111100111110110010101111001111
01000000001000001000000010000000000000000100000000000000000000000010000000000000000010000000000000000
11101111101101001111100101111001111110110111111011110111001010111001001001110011010111110011110110101
10000100001000000000000000001000000000000100000000000000000000000000000001000000000000000010000000000
11011110010111111001111100011011110101100011011111010110001111110011111011111001111001101101110101110
10000010000000000000010000000000000000000000000010000000000000000000100010000000010000000000000000100
11110101101110111101110101110111110011100100111110111111101011011111011010110111111011000111001110101
00000100100100000100010100000000000000000100000000001000000001000000000000000100000000000000000000000
01111101101111010101010111011011101110110101110011001110010101101100111101111010010000111011011110111
00001000100100010101010001000000100010010100000000000000000000000000000000000000000000000000000000000
11011011011110101101111110110111101101110111111101010110111100111011001101110111111011010101111101101
00000000001000000100001000000001000100000000100001000000000000000000000000000010000000000100010000100
01110111101111011010101110011110011111110011001010111100111001111101111101011010111110111111110110111
00010010000100000000000100000010000000100000000000000000000000000100100000010000000010000010000010000
11011100011101101100111101011001111111101001011111101011011011011110110111001111110100110110101011111
00000000000000101000000000000000010000000001000100000000000010000000000100000001000100000000000000000
10111101111100101101111110110110011110001110111011101110011111101010100111111011110111101100011110010
10000000000000100100000000000000000000001000000010001000000001000000000000000001000000000000000000000
11101011110101100101101011011110111011100111011111101000110111001011100011110101111110101111011101010
00001000000000000000000000000000010000000001001000001000000000000000000000000000000000000000000000000
10101001101110111010100111111111100110001110111111011011000101101101011000111011110110011011111010111
00000000000000000000000000010000000000000000100000000000000000000000001000000000000000000000010000000
11101100101101101110111111011101110110000011111111110111011111011101111111110111010010111001010111111
00000000000100100000010000010000000010000000000000010000000010001000001000000000000000100000000000000
