00000000000000000000000010000000000000000000000000100000010010000100000100010000010000010000000000010
01101101111011111100110111100111101100111110011101101111011000101101101101011111101110111011111011001
00000000001001000000010001000000000000001000000100000010010000000000000000000000000000100001000000000
11101011011101000011011111101011110110111111110011011100011111001010110011111111100111001001011110101
10000000000000000000000000001001000000001000000000000000000000000000010000000000000000000000001000000
11100110111110101101101101111110111011011110110101101110110110111000111110101011111111101101101011011
00000010001000000000000100001000010000001000000000000100010100000000000100100000000100001001000000000
01110111111111110111100000111101101010011111110101110100110111111001100101101010010111110111101111010
00000000100000000000000000100000001000000000100100000000000000000000100000000000000000000000000000000
10111100101101111100101111010110110111101101101011111101010101111001111111101100100010001101011111010
00000000000100000000000100000000010000101001000000000000010101000000000000000000000000000000000001010
10101011101111101011111001011111001110110111011110001111011101110011010100101111000110111110111110111
10000000000000001000000000000000001000000100000000000001000000000001000000000000000000000000000100001
11101011101110111111000111111100001101110110011110111011111111001011110000111010011111001111101011011
00000010000010000000000000000000000100000000000100000010000000000000000000010000000001000000000000000
11101110011110100011010110101111111111101110000110100011111101111111010111101110101011101111110111110
00000100000010100000000000000000001000000000000000000000000000100000000100000100000000000001000010000
10111001101111011111001001011111110111100111011101011011011111000111111011101100111111110011100111011
00010000000000000000000001000001000000000100000001001010000100000000010000000000000100000000000010000
01111111100110110011101111011101100111101110011101111011111100111101111101011111101011011101100111110
00000000000000000010001000010000000001000000000100010000100000000100000001000000000010000000000010000
11010111011111011111110101110011010001101011110111111100111101010001011101111111111110011110111101110
00000001000010001000000001000000000000000000000000010000000001000000000000000001000000001000010000000
10111011110011101110111010110111001110101110101101011111011100110011111001100110110110111110101110111
00100010000000000000100010000000000010101000000000000010000000000000010000000000000000000000100000000
01100111110110000011001110110110111111100111001111111010111011011111101100001111111101101111101110011
00000000000100000000000000000000000000000001000000001000000000001000001000000000001000000010001000000
01110010000111101001010101110111111101100011100111111111110001111011100001111100101001111011110111101
00000000000000000000000000000000000000000000000000000100000000000000000000000000000000001000000010000
11011011101101001111101101101111111111110111100001101111101001000000110100110111110111100011100110101
00000000001001000000000000001000000000000000000000000000000000000000000000000001000000000000000000000
11111001100010010101111011111110110110011110101111010111110011001101100101011100111101110010111110101
10000001000000000000000000000000010100000000000010000000000000000101000000000000000000000000000000100
01111010101110101111011100111011111000101110011111100100111111011110011100011101100111011110101101010
01000000100010000000000000000000000000000100000010000000000000000000000000000000000100010000000000010
10111010010111100010111010111101111111010101111000101001101111011110010011110010011010011000111111111
10010000000000000000000000000000010000010100000000000000000000000000000000000000000000000000000000000
11011001111100110101111011111100101001101111110101101110011011110110011011101110010100110101110111101
00000000000000100000000010000000001000000000000001001000000000100000000000100000000000000000000000000
11010111101011111111001110010011101011011101111001011111101010111001011010110101101110110101011011101
00000000100000000000000000000000001000000000000000010000000000000000000000000100000010000000000000000
01110010111111101110101111101010101101101110101011011111111101010010111111111000010100110111111011101
00000000000010000000100000000000000000001000000000000010000000000000010000000000010000000000010000000
11101111101101011011001111011011010011110111011111110011111101101110001111011111111101101100101110110
00000100000001010000000000000000010000000001000001000000001000000010000000000001000000000000000000100
10110111111100000111010011111110111100111111010110111110111001111101110111011111011011011110111100110
00100010000000000000000000000100000100000000000010001000010000000100100000001000000001000000000000000
10111110101001111010111111011011110101010111110111010001111011000111111101011101101011110111011100111
00001000000000001000000001000000000001000000000000000000010000000000010000000000001000000010000000000
10111110101110101101110101011111111011111101111010111110010010110101011110011111011000111110111111101
00000000001000101001000100000001000001000001000000000000000000010000000000000000001000000000000100000
10111001111111010110101000111110110011110101010111101111101111010110011110101011011011111001111001111
00000000010000000000000000000100100000010101000000000100000100000000000000000000010001000000010000000
10111101110011101010111110011111110011111011011011111101111010111000101110110111010010011110111111110
00010000000000001000000010000001000000100001000000010000000000000000100100000000000000000000000100000
10111101110111011110001011110110111101101101101010011101001101101110111011101101101011111101011111100
00000101000001000010000000000000000000000101000000000000000000000000000001000000100000010000000000000
11110010110101111011111010111111011110111110010111111001110111100111111111111011101000011110100111011
00000000010100001010000010000010000010100000000001000000100001000000001000000000000000010000000000000
10101111111100111010011001111111110011101111010111010101100111101011001001111111111011011100111110111
00100001000000010010000000000010000000001000000100000000000000001001000000000001000000010000000100001
01101100111011110111111010110001110111110111111110001010111100110111100111101110111110100110110101011
00100000000000000010000010000000000000000010000000001000000000000001000000000100010000000000000000000
10100111011110111110011001110111101111011001110001111100111111010111101110111011011110101110111011110
10000000000000000000010000000000001000000000000000000100000000000010000010001010000000101000000010000
01101011001111101110101111000010011001111011110111110111110110100111101011110011111011011001101101110
00101000000000000000000000000000000000000000100000100010000000000010000000000000100000000000100000010
10111111110010001101110010011111100101010111101101111110110110101101111000111111001111101111100111110
00001000000000000000000000000000000000000000000000100000100100000000010000000000000001000001000000000
10111011110111010110111100011111001110111010011101011110010110111010111110111110110111110001101101110
00001010000000010000000000000000000100100010000000000010000000000000000010000000010100000000000100010
11100111111101011101110101110111111100101110111111010001111111010111100111011111010101010111101110010
00000001000001000100000000000010000000000000100000000000010000000000000100000000000000010100000000000
11110110101011110110111101110011011111011110111110011100111011111110110111101111100101000011101111110
00000000100000010000000000000001001000001000000000000000100000100000100000000000000000000000000001000
01111101110101111111011001011110011111110110110011111001101110001000111111111010100101100101111101101
00000100100000000000000000010000000010000000000001000000000000000000000000000000000000000000000101000
11011100111111110110110111101101111011011011110011101011110110111011110001101111111110111011111101001
00001000000010000010000001000000100000000000000010000000010000001000010000000000000100010000000000000
11010111011110101111011101001111111100111011010011111110111001010101110110111101110111110101111011100
00010010001000000010000001000000100000000001000000000000000000000000000100010000100001000100000000000
11101111011001101100110111101010110110101000011100111101110110010111111110010100101110111110110111000
00000000000000000000000000000000000000000000000000001000000000000000000000000000000100000000000000000
01111101000011111110010111110010101111011111110010001110110011110101110111100111110011111101101110101
01000000000000000000000001000000000001000100000000000000000000000000100001000000000000010000001000101
01101111110101101110001111110111110011011010010111011001101111011011111000111110011011011110101011101
01000001000000100000000000000010000000000000000000000000000010001010000000000000000001000000000000000
11110111010110111111110001111100100111111101101101110111101101111100111111010101111101110110101110101
00000100010100100000000001000000100000000001000000000010001000010000001000000100000100000000000000000
01101011011101111111011110001111011101110101111010111111000110011111001111110111001111111010111011110
00000000000100001000000000000100001000000000000000100000000000000100000010000100000001000000100000000
01010011101111111111001011001111101101010111111001110101001111001110111111110001101110101111101111011
00000000000000010000001000000000000100000000000000100101000000000000000100000000000100000001000000001
10111111101111001010110110101110111011001101011111100111011110101011111111100110111010110110011101011
00001000000000000000000000001000000000000101000000000010010000000000100000000100010000000000000000000
10111011001111111111100101011011101011010111011110111001011110111101101110101111011010111110101011101
00001001000000010000000000010000001010000001010000000001000100100000101000000000000010000000001001000
11101011010111100011111101110111110110111101111011100111110111100110011111010110101011101110110111011
00001001010000100000000000010100000000100000100001000000100100000000000001010100101010000100100000000
11010111001111011100011111000111111110011111010111101111011101111010111110100111111010011001111101101
00000000000010000100000000000000000100000001000000100010001000000010000100000000000000001000000000000
