00000000000000000000010000000000000000000000000000000000000000000000000010000000001000000000000000000
01111101101101111111011011110101111001110110111101101110111010110110111101010101111011101001111110011
00010000001000001000010000000001000000000010000101000000001000000000001000000000000000100000000000000
10111110111110111001110111101010011101111100111010111011101101011111101011110111101001111101010110111
00000000100000100000010000000000000000000000100000001000000101000001000000010010000000000000010100000
11010110111110101101110100101111101101111101111101011001001111011111011010111101001111110110111011110
00010000000000100100000000000000001000001000001001000000000000000000000010100001000000000000100000000
01101111011111101000111010100110111101110010101011111100011011111100010111101011111100101111010111101
00000000000000000000000000000000100000000000101000000000000000000000010000001000000000001000000010000
10110111010111011111110001111111000011000111100111110101111111101111111101000111101001111110100001001
00000000000100000000000001000000000000000000000000000100000100001000000000000000000000000000000000000
10111100111011111000111101111100011101111011011110111101111010111111011001101011000110111111110010110
00010000000000000000010000100000000000001000000010000100000010000000000001001010000000000000000010010
01111101011101110110111011010110111011111100101101111011100111010001101111111010001101111010110011111
00000101010000100000000001000000000001000000000000100000100000000000000000001000000000000000000000000
01011010111110111100110101001111101011101111100100001101100101111111011111101010101100101111111010111
01000000000100000000000000000000000000001000000100000000000000000000000000000000001000000000100000000
10011011111101011111001011111101101111010101101011111111110011001010101101101011110110111110101001111
10000000000001000100000000010000000000000001001000100000000000000000000000001000100100100000000000001
01111011001110011010111011110110110111101100110111101101101101011011101101110111011011011101111011101
00100010000000000000000000100000000001001000000000001000000100000000000000010001000000000000010000100
11011010111111001111011101000001111111001111101110100011111101111111101011101111101010111011101110010
00010000000010000000000001000000000000000000000010000000000000001000001000100010000000000000000000000
01110011101010111111101100011111100111011101011010100110111101110101101111101011111010111011011101110
00100000000000000100000000000001000000000000001010000000000000000000100000001000010000000000010001000
10101101011110111111100111111110000100111101111011111011110010010111101101111010111011010111001101101
00101000000100100000000100000000000000000100001000000000000000000001001000000010100000000000000000100
11111110100011101101100011111110001111100010111011001011011110111100110010111101001101111010110110101
00000000000001000100000000000000000000000000000000000000000100000000000000001001000000000000000010100
11100111110111111000111001011001011111111001111011111001110001101011111100011011111111100111101111101
00000000100000000000000001000000000000000000100001000000100000000000000100000000000010000000000100000
01011110011110111100011110011111111001111001111011101101101011011010110111100111011011011011111001110
00000000000000000000010000001000000001000000100010000000000000000010000000000001010010001000000000000
01111001011101101110111110011011101100011010111001111011110111001111110110101010110111111010111100111
01000000000100100000000000000000000000000010010000001000000000000100000000101010100001000000010000000
01101101001111101111001110111001111111101110101000110001110110101111011101111010101111011101110101010
00100000000000000100000000001000000000000000000000000000000010100000001000000000100001010000000101010
10111101001111111110001111110101111011011101110001011001011101111111110111101110011111011011001001111
10001000000000000000000100000100100000000000000001001000000000000010000010000100000000000000000000000
10101101110111011111111111010010010110011101011101010101111001001110110111110101010011011111101110101
00000000010010000100000000000000000000000000000000000000000000000100010000000100000000000000000100100
01011100111110011111011100011111011101011110110011011111100011110100011111111010111110001001111011101
01000100000000000001000000000000000000010000000000000000000010000000000001000000000000000000010010000
01011111011110111101110010110010111011110111010101101101011001011110111100111111111001010110111101011
00000010000100100000000000000000000010000000000000000001001000000000000100000000000000000100000001000
11011110111110001100010100111111111101101101101011111011101111110100010010101111110111101110111011110
00000000000000000000010100000000100000000001000000100000100001000000000000000000000000000010000000000
11100110011111001101111010010101011111011110011111101111100110111111010111010110011110110011110111101
10000000000000000000000000010101000100001000000001000001000000000000000100000010000000000000010000000
11100011101101111101101110110110011111010110110011111011111011110111110011101101001111110101001001111
00000000000100000101000010000000000001010000000000001000010001000100000000100101000000000000000000000
11010000100111011111111111101111001111011111101001111100111011110011111011111100110111010101110011110
10000000000000000000000010000010000001000010000000000000010000000000100000100000000000000000000010000
10011111110101111110101011110101101101011110101111101010001011011111001110110110111001111101011011101
10000000010000000000001000010100000000000000000000000000000001000000000000100010100000000100000000000
01111010110011010111101011101001001111111111101011111101101011101101110011101011111100111111100110111
01000000000001010010000001000000000000000100001000000000000010000100100000000000001000000001000000000
10111111011000001111001111111011000011100111111011111001111110011101111101111111110100011001101100111
00000100000000000000000000000001000000000000000000001000000100000000001000010000000000000000000000000
01011101101110111110101111111000111010111111001110111101111011010101101110111101100101111010111101110
01000000100000010000000010000000000010000010000000001000010000000000000000001000000000000000010000010
11101110101111000111101010101111011110111111110100011110011001011111101011111100100010111110111010111
00000000000000000010001010100000000100000000000000000000000001000100000001000000000000000000001010000
11010001111000011011111111110010111101110111111010101111101010111100111101110011101110111101011110101
00000000000000000000000001000000000100010000000010100010000000001000000101000000000000010001001000000
01111011100110111110111011101011110110101110011011101110101110110101111101110111110000111101111101110
00001010000000000100000000000001000100000000000000000000100000010100000101000010000000000000000001000
10111011001100111011111010101011110111011011011111011110111011011010111101011111111100001011101111011
00100000000000000000000000000010000000010010000010000000100000010000000101000000000000000000100000000
11011101101111011111001110010111110111101111010111110110110010101011111111101001010111110101010111111
00000100000000000000000000000100000100000100000000100100000000000000000000000000010000010000000000000
11101110011110111100011110110111011000111111110011011110110010101111101111100111111100101101101011101
00001000000100000000000000100000001000000000000001010000000000000001001000000001000000000000000001000
11001010111101111101111101010101101111010110010111110111111001010101010111101110100111010111011101101
00000000000100010000000000000001000001000000000000000000000000000101000000000000000000000010000001001
00011100111111111101011011011110111011001111011001111010010111111011100110110011101101110111111010101
00000000000000100001000000000100000000000010000000000000000000100000000000000000000100000001000000000
01111101010100011111110001110111110111111101111000101110111111010011101111101110011001110001111001010
00000000010000000000010000000000010000000000000000001000001000000000000000000000000000000000000000000
11011101110110100111011111011011011110101010110011010111110011101110001111111100110111000111111011110
00001000000000100000000000000010010000100000000000000000000000000010000000000000010010000000000001000
00110111111011101101101110111001110111011110101000111011111011100101111111011010111111011101101101101
00000000000010000001000000100000000001001000000000000000010010000000001000010000000010000100000000000
01111101011101111101011101010111001111011011100101011110010110111101110100110001111111101011010110111
00100001000000100000000001000000000001000000000000000000000000000000000100000000000000100000000000000
11110110101010111111110111111100111011010111110010111011111011111011001100101111011101011101110110101
00000000000010000010000010000000100010000000000010001000100000100000000000000000001001000000000000000
01101111111101000100111110101100111110001111101110111001101111101110111101110100110010111111011011010
01000100000000000000001000000000000010000000000000000000100000100100000100000000000000000000000000010
11011010110111011010100111100101110110111011110101111011011111000111101011011111011001110011101101101
00001010000001001000000000000000000000000000100000000010000000000000101001010000010000000000000000000
01101111101000001101110111011110100111001111110001111100110111100110111011011111011010111100111110011
01001000000000000000000000000000000001000000000000000000000100000000010000000100000010100000010000000
10110111101001011101011011110111011011011101101111101011010101011111011110101110011110101110101010110
00000000000000001001001000000010000000000000101000001010000000000010000100100100000000000000000000010
11011001101111111000011111011011100101011101100011111110110011011111101001110111101111100110111111010
00000000000000000000010000010000000000000000000000000000000010001000000000100010000100000000001000010
10110100111111110011010110011000111111110111010011111110010011101110110100001111011101101110110101110
00000000000000000000000100000000000000000000000010000000000001000010000000000000000000000000000000100
01111011111110110111000111101100000110110110011101110011010111111101101101110110011111000101110111101
00100000000000000000000000000000000100000010000000000000000000010000100000000000000010000000000000000
