00000000000000000000000000001000000010000000000001000000000010000000000010000000000000000000001011000
11111101100110011001101111101001101101101110111101011110001111110110110111101110101110111111111101000
00000000000000000000001000000000000001001000100000000100000000000010100100000000001000010000000000000
11011110011111011001011110011001110111111111001011101000110110111011111111101010110011011101111110011
00000000010000000000000000000000010000000000000000000000100000010000010000000000000010000100001000000
10001111110111101101100101111111110111011110101111101111101110110111101100011101101111010111011010111
00000000000100000000000100000100000100000100100100001000001000000100000000000100000000010000000000000
10110101101111110011110011000111011101011111011011111011101110110011011110111110011111010101011110101
10000000000010000000000000000000000100000000000010000010000000000010001000010000000000000001000000000
10011000010101111111110111101110111101111101001111011011011001011111110011110101011111000010111110110
00000000000000000000010000100000001000000001000000000000000000000010000000000000000000000000010000010
10101111100111011011001101011011111001011110101111101101110101110101101101111011111001110101111001011
00100100000001001000000000000000000000000100000010000101000000100000000000100010000000100100000000000
11011011101011011101101101111111100011110111010110111011100111010110100110101111100111111110111011100
10000000101010001000100000000000000010000100000010000000000000000100000000000000100000000100000000000
11111011010100101111010110111110110111101110100111111010110111101100111110111100011011011110111101001
00000000000000000010000000000000100000100000000000010010010010000100000000000000001000000100000000000
10111001111101011111101011111011011111110101011110111010010101111111001101011111100100110111101111011
00100000000100000001000000100010000010000001010000000000010000001000000000000000000100000000000001001
11100101011011101111100101110101111010111010101101111101101101011111001101110111110010010110101011110
00000000000000100000000000100101000000000010000000001001000000000000000001000000000000000000000000100
01111010110111010111011111101011111111011111010101110101111111011001100101111101101111011110101111011
00001010000001010100001000001000010000010000000001000100100000000000000000100001000000010000000010001
01111100001111110010100101111111111111101101000110111001111011100001101100010111110111101110110111110
00001000000000000000000000000000010000000000000000010000000000000000000000000000000000000010100000000
11010100111011001111011110111111111100111010000111110110100010101111101011011101101011100101111010110
00000000000000000000010000100000000000000000000000000000000000000100000000010000000000000000000000000
01010000111111111111011110110010100111111010110010011111111010111011100110111111011101110111001001111
01000000000000001000001000000000000000001000000000000000000000100000000010001000001001000100000000000
01111110100101110111101101011010110110011011000110111010111110111001011110001111101101111101101111011
00000000000000000000000000000000000000000000000100001010100000000001010000000000001000001000100010000
11010101111011110010110001111111000011001111110111010111010101011001111111111011010101111011011011110
00010100100000000000000000001000000000000000000010000001010000000000000001000000000100010001000000010
11010110111111111001111001111011110111010111101011111110010110111110101101110011110011011001111110111
10000000000100000000100000001000100100000000100000000000000100010000100000000000000000001000000100000
11011011101111110100110011011110111111100111011111101100011101101111011101011011011111010111101111011
00000001001000000000000001000100001000000001010000000000001000000100000000010010000010000000100000000
11011111100011010111111110101110110011101111011111110100000100111111011110101010110011101111110111110
00000100000000000000100000001000100000000000001000000000000000000000000000100000000000000000100000000
11010011100110111111100101011110111001111011111010111111100101111010111101100111111011111010101010110
00000000000000000010000000000000000000010001000000100000000001000010010000000000100000000000000000010
10111010101111011111011100101011101101011111000010001011110111111011010101101111110110111110011110110
00000000000000010000010000000000000000000000000000000000000000010000000000000001000100000000010000000
01101111101001110011111111000101101001101101101111110110111110011101101001101110011100111101111101110
00000000000000010000000010000000000000000000000000000000100000010000000000000000000100000000000001000
11001011101111111110011100110110110111101011110110110111110001100111110111111011111110010111110111101
00000000000001000000010000000000010000000001000000100000000000100000010000100000100000010100000100000
11011110111101000010111011110111010010110111111111110110111101110010010001101011011011001111101101101
00000000000000000000001001000000010000000000001000000000000000000000000000001000000000000001000000100
01111111101110100011011110101011101111011010111111001101101110111101111110110011111110101111111000110
00000000000000000010000010100000000010001010000000000101000100000000100000100000000100101000000000000
11101110111101011110110111011111111100010111011101000111110110100011111110110000101111111011011111001
00000100000000001000010001000010000000000000001000000000000000000000000000000000000000100010001000000
01101111110111101011101111100010010111111110111010100001111111001011111110111010110110101111110100111
01000001000000000010001000000000000000001000000000000000000001000000000000100000000000100010000000000
10101110111011110101011110101001111011101110110011111011111100110100111111101001010111110111101111010
00100000010000000000000100101000000000100100000000001000000000000100000001001000000000000000101000000
10111110100111100011101010011111111101110011111101101111010010100111100111011111011011011110001101110
10000000000001000000000000000000000000000010000000000000000000000010000001000000010000000000000000100
01101101111111101000110111101011110101101001111011111011010001100111110101111111111100111011100111101
00100000000100000000000000000001000000000000000000100001000000000000000000000010000000010000000000000
11111011011111010111100111011111011001110111110101111101100011111101101011010011011110110111101101101
10000010010000000010000001000001000000000000100000001000100000000000000000000000000010000000001001000
10111101111001111100101111110111001011111101011101010111101101110010110110111111100011110111001111010
10100000100000000000000100000000000001000001010000000000000000000000100000000100000000010100000001010
10101111010110111101110110101111011111100011001001111101011100110011111101101011101001011111010111010
10000000000000000001000000000010000000000000000000001001000000000000000000000000000001000100000000010
01111100010011111100111011011011011101000011011111110110110111110101111101110011111101001110110101111
00100000000000000000000000000010000000000000000000000100000010000000010000000000100000000010000000000
10101111110111001011111100111111110010001101111100111111100111110111100110011111110000101111010011111
00100000000100000000000000100000000000000100100000000100000010000000000000001000000000000001000000000
01111001010111111101010101001011011111111111111110111001001100011001011011110111001100111110111111010
00000000000000000000000101000000000000100000000000000000000000000000010000000000001000000100010000000
11101110110111111001110110111010011100011101111101100011101011110100111110111100111011101101111101011
00000100100001000000000010000000000000000000001000000000000000000000000000010000000000000100001000000
11110010100010110111011111110001101010111001111111100000111111011100111010011101111011010111110011101
00000000000000000000000000000000000000000000010000000000000010001000000000000000001000000000000001000
10101110111011011111101110100101111110100110011101111011111010111111001010111110110101110001101110101
00000010000000001000000000000100001000000000000000001001000010000000000000000000000000000000001000000
11011110110001111011111111101001101111101010111110011110101111101111010101101111010111110101110101001
00010000000000001000001000000000100000000000001000000010100001000010000000000001000000000000000000000
10111011111011001100110110010111010101100111110110110111100101100111010011101100111110011111110110101
00000000000000000000000000010001000000000000000010000000000000000000000000000000000000000100000000001
00011110111001011011110110111101000011111111111011001110111011001111101011101101001111011011001100111
00000000000000000000000000010001000000000000010000000000000010000000000001000101000000000000000000000
10110110011110110110101111101111101010111101101101110111010111100111111100111001111000111111111100101
00100100000010100000000010000100000000000001000000000010000000000000100000000000010000000001000000101
11110110101111100011110101011010111101011101111001001100011011001111111101101101101100111101110111011
00000000100010000000000000000000000001000000000000000000000000000000010001000000000000001000010100000
11010101011101011101110111101101111010111111101000101010111101111001101001000001111011110111011111011
00000000000000000100000001001001000010000000000000000000001000100000000000000000000000000000000001001
10011100011000101111101111111001011110111111010100111110110111110110011111101010100111101110011111010
00000000000000000000000000000000000100000000000000010000100010000100000000000000000000000000010000000
01101111011011010100111111011101010100111110110111101010111110100011111010111011101011011101100111010
00101000010010010000000000000000000000000100000001000000000000000000010000000001000000000000000000010
00100101110110111111101111010100101111101110111011101011100111011110110110111110110101011111101111010
00000000000000000000101000000000000000101000000001001010000000000000100000001000000000000100001000000
10111011101110000001111100011010011111110111111010011100111111110101111111110011110111010111101011011
00100000100100000000000000000000000000000000001010000000000000100000000100000001000000010000000000000
11011101101111010111101100111101110111010111001111101010111011111110011101110101101101111011101011011
00000101000000000100000000000001000100000000000010000000001000010000000000000101000000100000001010000
